############
#...#......#
..#.#.####.#
###.#....#.#
#.T..###.#..
####.#.#.#.#
#..#.#.#.#.#
##.#.#.#.#.#
#.....S..#.#
######.###.#
#......#...#
############
