..###################################################################################################
....#.......#...#.#.#...................#.#...#.#.#.......#.#.......#.#...#.#.........#.......#.....#
###.#.###.#####.#.#.#####.#####.#.#####.#.#.###.#.#.#.#.###.###.#.###.###.#.#.#######.###.#####.#####
#.....#.#...#.......#...#.....#.#.#.......#.#.....#.#.#...#.....#...........#.#...#...#.#.#...#.....#
#.#.###.#######.#####.#.#.###############.#.###.#.#.#####.#####.###.#.###.#.#.#.#######.#.###.#.#.###
#.#.....#.....#.#...#.#.#.#.......#...#...#.#.#.#...#.............#.#...#.#.....#...#.......#.#.#...#
#######.#.###.#.#.#####.###.#######.###.###.#.#.#.#.#######.#.#####.#.#####.###.#.#.#######.#.#.#.###
#.#.#...#...#...#...#...#...#.#.........#.....#.#.#.#.......#...#.#.#.#.#...#.#...#.#...........#...#
#.#.#.#######.#.###.#.#####.#.#.#.#######.#.###.###.#.###.#.#####.#.###.#####.#####.#####.###.###.#.#
#.#.....#.#.#.#.......#...#.#...#...#...#.#.#.#...#.#...#.#.#.#.#.#.#.............#.....#.#...#.#.#.#
#.###.###.#.#####.#######.#.#.#.###.###.#.#.#.#.#.#########.#.#.#.###.#.#.#####.###.###.#####.#.###.#
#.....#.#.S.#.....#.......#...#.#...#.#...#.#...#.#.#.......#.......#.#.#.....#.....#.....#.#.#.....#
#.#.###.###.#.#.###.#####.#.###.#.###.#.#.#####.###.#####.#######.#.###########.###########.#.#######
#.#.....#.#.#.#...#.#...#.....#.#.#...#.#.....#.#.....#...#...#...#...#...#...#...#.#.#.........#.#.#
#####.#.#.#.#.#.#####.#.###.#########.#.###.###.#####.#.#.#.#########.#.###.#####.#.#.#.#.#####.#.#.#
#.....#.#.....#.#.....#...#.....#...#.#.#.#.#.#.#.......#.....#.....#...........#.....#.#.#...#.....#
#####.###.#.###.#.###.###.#.###.#.#.#.###.#.#.###.#.#.###.###.###.#.#.#####.#.#.###.#.#.###.#########
#.#.......#...#.#...#.#.....#.#...#...#...#.#.#...#.#...#.#...#.#.#.....#...#.#.#.#.#.#.#.........#.#
#.#.#.###.###.#####.#####.###.#.###.#####.#.#.#################.###.#.#.###.###.#.#.###.#######.###.#
#.#.#.#...#.#.#...#...#.#.....#...#...#...#...#...#.#.#...#...#.#...#.#.#.....#.#.#.#...#.#.#.....#.#
#.#.#####.#.###.#######.###.#######.#.#.#.#.#####.#.#.#.###.###.###########.#####.#.#.#.#.#.###.###.#
#.#.....#.#...#...#.....#.........#.#.#.#...#...#.#...#...#.#.....#.............#.....#.....#.......#
#.#####.#.#.###.#######.#####.###.#########.#.###.#.###.###.###.#.#.###.#.###.#.###.###.#####.###.###
#...#.#.#.#...#.............#.#.....#...#.#.....#...........#.#.#...#...#.#.#.#.#...#.#.......#.....#
###.#.###.###.#.#####.#######.#####.#.###.#.###.#.#.#.###.###.###.#####.###.#.###.###.#####.#.#####.#
#.#.#...#...#.....#...#.........#...#.....#.#...#.#.#.#.#.........#.#.#.#.......#.....#.#.#.#...#...#
#.#.###.###.#.#.#####.#.#.#######.#######.#.#.#.#######.#.###.###.#.#.#######.#####.#.#.#.#######.#.#
#.......#.....#.#.#...#.#.#.#...............#.#.......#...#.....#...#...#.....#.#.#.#.#.....#.....#.#
#.#.#.###.#.###.#.###.#.###.###.#.#####.#.#########.#######.#.#.###.#.#.#####.#.#.#.#.#.###.###.#####
#.#.#.....#...#...#.......#.....#...#...#...#.#.#...#...#...#.#.#...#.#...#...#.....#...#...#...#...#
#######.###########.#.#########.#.#.#########.#.#.#####.#########.#####.#.#.#.###.#########.#####.###
#.#.#.#.#...#...#...#.#.........#.#...#.....#.#.....#...#...#.....#.#.#.#...#.........#...#.........#
#.#.#.###.###.#.#.#####.#.#.#.#.#########.#.#.#.#.###.#####.#######.#.#.###.#####.#####.#.###.###.###
#...........#.#.#...#.#.#.#.#.#.........#.#.....#.#.#.#.#.....#...........#.....#...#...#.#.#.#...#.#
#.#####.#.#.#.###.###.###.###.#.#.#.###.#.###.###.#.#.#.#.###.#####.#.#######.###.#.#.#####.#.###.#.#
#...#.#.#.#...#...#.....#.#.#.#.#.#.#.#.#.#.....#.#.......#...#.....#...#.....#...#.#.#.#.....#.#...#
#.###.#####.#.#.#.#.###.###.#.###.###.#######.#####.#.#.#.#.#.#.#.#####.#####.#.#####.#.###.###.#.#.#
#.#.#.....#.#...#...#.....#.....#...#...#...#.....#.#.#.#.#.#.#.#.....#.#.#.#.#.#.....#.#...#.#...#.#
#.#.#.###.###.###.#####################.#.#######.#.#.###.#########.#####.#.###.#.#.#.#.#.###.#####.#
#...#...#.#...#.#.#.....#.....#...#.#.#.....#.#.....#.#.....#.....#.#.........#.#.#.#.#.#.....#.#...#
#.###.###.#####.#.#.#####.###.###.#.#.#.#####.#.#.#######.#####.#.#.#####.###########.#.###.#.#.#####
#...#...#.#...#...#.....#.#.....#.#.#.....#.....#.......#...#...#.........#.......#.......#.#.#.....#
#.#.#####.#.#####.#.#####.#.#####.#.#####.###.#.#.###.###.#####.#######.#.###.#####.#####.###.#.#.#.#
#.#.#.#.#...#.#...#.......#.#.....#.#.......#.#.#.#...#...#.#.....#.#.#.#...........#.......#...#.#.#
#####.#.#.#.#.#####.#.#.#####.#####.###.#########.#.#####.#.###.###.#.###.###.###.#######.###########
#.......#.#.#.......#.#.#.......#.#...#...........#.#...#.......#.....#...#...#.......#.....#...#.#.#
#.#.#.#####.#.###.#######.#######.#.###.#.#############.#.###.###.#######.#########.###########.#.#.#
#.#.#.#.....#...#.#...#...#.#.#...#...#.#...........#...#.#...#.#.....#.....#.....#...#.........#...#
#####.#.###.#.#.###.#####.#.#.###.###.#.###.#.#.#.###.###.#####.###.#############.#.###.#####.#.###.#
#.......#.....#.#.......#.......#.........#.#.#.#.#.#...#...#.....#...#.....#.#...#.#.....#.#.#.#...#
#.###.#####.#.#.#####.#####.###.#.###.#########.#.#.###.###.#.#####.###.#.###.###.#.#.#####.#####.#.#
#...#...#...#.#.#.......#...#.....#.......#...#.#...#.#...#.#.....#.....#...#...#.#...........#...#.#
#####.###########.#.#.###.###.#############.#.#.###.#.#.###.###.#####.#.###.#.###.###.###.#.#.#.###.#
#...#.....#...#...#.#.#.#.#.#.#.#.....#.#.#.#.#...#.#...#.#.#.........#...#...#.#.#.....#.#.#.#.#...#
#.#.#.###.###.#.#.#.###.#.#.#.#.###.#.#.#.#.###.#######.#.#.#.###.###.#.#####.#.#.#.###.#####.#.#####
#.#...#.#.#.....#.#.........#.....#.#.......#.....#.........#...#.#...#...#.#.#.....#.....#.#.#.....#
#.#.#.#.#.#.#.#.#######.###.###.###.###############.###.#.#.#########.###.#.###.#.#.#.###.#.#.#.#####
#.#.#.#.....#.#...#.......#.#...#...#...#.......#.#...#.#.#.#.....#.....#.......#.#.#.#...#.........#
###.#.###.#.#.###.#.#.###.#.#######.#.#.###.#.###.#####.###.#.#.#####.#.#####.#.#########.#.#########
#.#.#...#.#.#.#...#.#.#...#.........#.#.....#.#.#...#...#...#.#...#...#.#.....#.#...#.#...#.#...#...#
#.#.#################.#########.#.#.###.#####.#.#.#####.###.###.#.#.#####.#####.#.###.#####.###.###.#
#...#...............#.#.....#...#.#.....#...#.......#...#.#.#.#.#.#...#.#...#.#.....#.#.....#...#...#
#######.#######.#####.#.#########.###.#.#.#.###.#####.#.#.#.#.#.#####.#.###.#.###.#.#.#.###.#.#####.#
#...#.......#.........#.....#...#.#...#.#.#...#...#.#.#...#.#.......#.....#...#...#...#...#.#.......#
#.#######.#########.#######.###.#######.#####.#.###.#.#.#.#.#####.###.#.###############.#########.###
#.....#...#.......#.....#.....#.#.#...#.....#.....#...#.#.#...#...#...#...#.#.....#.#.....#.....#.#.#
#.###.###.###.#.#######.#.#####.#.###.###.#########.#.#.#.#####.#.#######.#.###.###.#.#####.###.#.#.#
#...#.#...#...#.....#.....#.......#...#.......#.....#.#.#.......#.....#.#...#.#.#...#...#.....#.#...#
#.#####.#####.###.###.#.#.#.#.#.###.#####.#.###################.#.#####.#.###.#.#.###.###.#.###.#.#.#
#.........#.#.#.#.#.#.#.#.#.#.#.#...#.....#.#.#...........#.#.#.#.#.#.....#...#.#.........#.#.....#.#
###.#####.#.#.#.#.#.#######.#######.#####.###.#.#####.#.###.#.#.###.#.###.#.#.#.#.###.#.#####.###.###
#...#.#...#...#.#.........#.#.....#.#.........#...#...#.#.........#.....#.#.#.....#...#...#.#.#.#...#
#####.#########.#.###.###.#.#.#####.#.#####.#.###.#.###.#####.#######.###.#.#.#.#######.###.#.#.###.#
#.#.........#.#.....#.#...#.#.#...#...#...#.#.#...#...#.#.#...#...#.#.#...#.#.#.#.....#.#.#.......#.#
#.#####.#####.#.#.#.#####.#.#.#.#####.#.###############.#.#####.###.#.###.###.#.#.#.#.#.#.#.###.###.#
#...........#...#.#.#.#.........#...........#.#.......#.#.....#.....#.#.#...#.#.#.#.#...#.....#...#.#
#.#.###.#####.#.#####.#.###.#####.#####.#.###.#.#.###.#.###.###.#####.#.#####.###.#.#######.#.#####.#
#.#.#.#.......#.#...#...#...#.#...#...#.#.....#.#...#.......#...#.#...#.....#...#.#.....#.#.#.#.#...#
###.#.#.#.#.#####.#.#######.#.#####.###.#####.#####.#######.#.#.#.#########.#.#####.#####.#.###.###.#
#.....#.#.#.#.#...#.#.......#.......#.....#.....#.....#.....#.#...#.#.....#...#.#...#.....#.....#.#.#
#.#####.###.#.#.#.#.#######.#.###.#.#.#######.###.#########.###.###.###.#######.#.#.#.###.#######.#.#
#.#.#...#.....#.#.#.#.#.....#...#.#...#...#...#.....#.#.......#.#.........#.....#.#.#...#...#.#...#.#
###.#.#####.#####.###.#####.#.###.#######.#.###.#####.#######.#.###.#.#########.#####.#.###.#.###.#.#
#.......#.........#.#.#.....#.#.#...#.........#...#.....#.#.#...#.#.#.#.#.........#.#.#.#.#.......#.#
#.#.#.#.###.#.#####.#.#.#.###.#.#.#.###.###########.###.#.#.#.#.#.#.###.#####.#.###.#.###.#####.###.#
#.#.#.#...#.#.....#...#.#.......#.#.#.....#.#.#.....#.#.......#...#.#...#...#.#.#.#.....#.#.....#...#
#.#########.#######.#.#.#.#.#.###.#.#.#.#.#.#.###.###.#####.#.#.###.#.###.#.###.#.#.#.###.#####.#.###
#.#...#.#.....#...#.#...#.#.#.#.#.#.#.#.#.#...#...........#.#.#...........#.#.......#.......#.#.#...#
#.#.###.#####.###.#####.#####.#.#####.#.###.#####.#############.###########.#.#.#.#.#.#####.#.###.#.#
#...#.......#.........#.#.......#...#.#...#.#.....#...#.#.#.#.....#.........#.#.#.#.#.....#.#.....#.#
#.#.###.#############.###.#.#.#####.#.#.#.#.#####.###.#.#.#.#####.#.###.###.#########.#.#.#.#####.#.#
#.#.....#.#.....#.......#.#.#.#.#.....#.#.....#.............#...#.#.#...#.....#...#...#.#.#...#.#.#.#
#.#####.#.#.#####.###########.#.#######.#######.#.#########.#.#####.###.###.#.###.#.#.#.#.#####.#.###
#.#...#.#...#...#...........#.#.............#...#...#.........#...#.#.....#.#.#.....#.#.#.....#.#...#
#.#.#####.#####.#.#.#######.#########.#.#####.#####.#.#####.#.#.#####.#####.#.#####.###.#.#.#.#.#.###
#.#.............#.#.......#...#.#...#.#.#...#.....#.#...#...#.#...#...#.#.#.#...#.....#.#.#.#.#...#.#
#.###.#####.###.###.#######.#.#.#.#.#####.#####.#####.#.#####.#.#.###.#.#.#####.#####.#.###.###.###.#
#...#.....#...#.#...#.......#.....#.....#.#.....#...#.#...#...#.#.#.........#.#.#...#.#.#...#.......#
#.#.#######.#####.###.#####.#.#.#.#.#####.#.#.#.#.#.###.###.#.###.###.#######.#.#.###.###.#####.#.#.#
#.#.#.............#...#.....#.#.#.#.....#...#.#...#.#.....#.#.....#...#..........T......#.......#.#.#
###################################################################################################.#
